TableName	Describe	Comment
Task	任务系统	
Lib	常用函数库	
Timer	计时器系统	
Dialog	对话管理系统	
PlayerEvent	玩家事件处理模块	
Dbg	调试库	
TaskAct	任务编辑器可执行操作	
TaskCond	任务编辑器可判断条件	
LinkTask	任务链	
Npc	Npc脚本系统	
Item	装备脚本系统	
TreaBox	随机任务宝箱系统	
RandomTask	随机任务	
Env	TODO: xyf 游戏基础常量、函数定义，暂定名	
FightSkill	战斗技能脚本系统	
Player	角色脚本系统	
GM	为了方便调试提供的GM指令杂项	
Setting	杂项数值设定	
Mission	Mission的脚本系统	
ServerEvent	服务端事件	
ClientEvent	客户端事件	
GCEvent	Gamecenter事件	
OffLine	离线相关的处理	
Compound	道具合成、升级相关脚本	
ChatRoom	聊天室相关	
Obj	道具（掉地上那个@_@）	
Map	地图相关脚本处理	
Shop	商店	
Gift	给予界面	
BiWu	擂台比武	
ScrollTask	卷轴任务	
GeneralAward	通用奖励	
M3_Test	M3 演示引导界面	
TreasureMap	藏宝图~ 赞~  -- by peres	
MapMaker	地图册制作相关功能 -- by peres	
GeneralProcess	通用带计时器的进度条	
TaskAwardCond	任务奖励条件	
BubbleCond	聊天泡泡条件	
BlackSky	任务黑屏处理	
Kin	家族	
Tong	帮会	
c2s	供客户端直接调用的服务端脚本函数	
Mail	邮件系统	
IbShop	奇珍阁脚本	
HuiHuangZhiGuo	辉煌之果活动	
Battle	战场	
Relation	人际关系	
LifeSkill	生活技能	
BaiHuTang	白虎堂	
PlayerSchemeEvent	定期事件	
FactionBattle	门派竞技	
JbExchange	金币交易所	
FactionElect	门派选举	
Boss	Boss系统	
PopoTip	提示泡泡	
Ui	UI系统	
UiHelp	帮助系统	不知道怎么合到UI里
UiCallback	UI回调机制	临时的，以后要删掉
UiManager	UI管理	临时的，以后要纳入Ui.tbMgr
UiNotify	UI事件响应机制	临时的，以后要纳入Ui.tbLogic
UiShortcutAlias	UI快捷键	临时的，以后要纳入Ui.tbLogic
Xisuidao	洗髓岛	
GuessGame	猜灯谜活动	
Log	日志对象	
PlayerCourseLog	日志对象：玩家历程	
HelpQuestion	帮助问答	
Trade	交易	
TradeTax	交易税	
Ladder	排行榜	
EventManager	活动系统	
KinGame	家族关卡	
ChatChannel	聊天频道	
Stall	摆摊	
League	战队	
Account	账号相关	
TimeFrame	时间轴	
SpecialEvent	特殊事件（如补偿，各类玩家事件）	
Merchant	商会系统	
PlayerHonor	玩家荣誉系统	
Wanted	官府通缉任务	
XoyoGame	逍遥谷闯关	
StatLog	统计Log	
jbreturn	金币消耗返还	
PresendCard	激活码卡认证	
PProfile	个人信息	
Wlls	武林联赛	
Auction	拍卖行操作	
GblTask	全局变量	
UiEditor	UI编辑器	
Faction	门派	
Bank	银行	
DeRobot	反外挂	
Domain	领土争夺战	
WeeklyTask	周任务	
Esport	竞技赛(新年雪仗)	
Spreader	消耗型推广员系统	
CoinExchange	绑银兑换	
VipPlayer		vip玩家
Baibaoxiang	百宝箱 	
GmCmd	客服指令	
SkillEnchant	技能附魔	
Console	控制开关	
Stats	潜在流失玩家数据统计	
Union	联盟	
Looker	观战	
Lottery	09年8月促销抽奖	
Wldh	武林大会	
NewLottery	09年9月促销抽奖	
Transfer	跨服	
EPlatForm	活动平台	
VFactory	差异脚本机制，用于多版本	
DaTaoSha	大逃杀
Youlongmibao	游龙密宝	
Achievement_ST	成就系统（师徒）	
Achievement	成就系统	
GbWlls	跨服联赛	
CFuben	副本机制	
Lock	锁机制	
Partner	同伴	
Marry	结婚系统	
TowerDefence	炮塔防守（植物大战僵尸）	
Question	通用的答题系统	
Xkland	侠客岛
FightAfter	战后系统
TreasureMap2	藏宝图2
DataLog	数据平台
BeautyHero	巾帼英雄赛
Newland	铁浮城	
DriftBottle	漂流瓶	
KinBattle	家族战
CastleFight	夜岚关	
KuaFuBaiHu	跨服白虎
Sns	社交网络相关	
Atlantis	楼兰古城	
XiakeDaily	日常任务
AutoTest	自动测试	
AutoTeam	自动匹配组队	
SuperBattle	跨服战场	
ChatFilter	客户端聊天过滤
KinGame2	高级家族关卡	
Weather	天气
HomeLand	家园
StudioScore	角色评分
SelfProtect	自我保护
IpStatistics	登录IP统计
WeekendFish	周末钓鱼
CrossTimeRoom	时光屋副本	
NewEPlatForm	新活动平台
Tutorial	指引
MiniResource	地图资源
KinPlant	家族种植
Keyimen	克夷门
ChenChongZhen	辰虫镇副本	
MemoryMgr	内存策略管理
CardAward	卡牌通用奖励
SeriesPk	连斩PK特效
NewBattle	新宋金战场	
KinRepository	家族仓库
Kinsalary	家族工资
ClientOptimizeMgr	客户端优化管理器
LimitLogin	Giới hạn đăng nhập
ShengLongChen Phi Long Đạo
